1.Unity is the guarantee of  victory  团结就是胜利的保证
norm	常态  规范  标准
victory	胜利 成功
closure	倒闭 封闭 宽慰
Norman	诺曼 诺曼人



2.the bomb caused a ---- explosion   炸弹引起了巨大的爆炸
normal	正常的  精神正常的  意识健全的
Norman	诺曼 诺曼人
gigantic	巨大的  庞大的
convicted	   证明有罪的  已被判刑的


3.there was not enough evidence to --- her  没有足够的证据证明她有罪
victimize       使受害 使受苦
normalize	正常化 标准化 
convict		定罪  宣判 。。。有罪
evince	显示  表明  


4.they complained of sex discrimination and --- 他们抱怨受到性别歧视和迫害
protestantism	新教
abnormality	异常（人身体或者行为有危险性特征）
normalization	正常化
victimization	欺骗 牺牲 迫害


5.the government is under ---- pressure financially  政府在财务上承受着巨大的压力
provincial		省的  地方的  
victorious		胜利的  获胜的
enormous	巨大的 极大的
convinced	确信的 坚信不疑的 


6.he criticized the --- for being violent and ruthless  他批评驱逐行为是暴力和无情的
victims	牺牲者 牺牲品
evictions	驱逐
closets	贮藏室 壁橱
normalcy	常态


7.the full --- of the crime has not yet been revealed  这一罪行的严重性还没有充分揭示出来。
victor	胜利者 获胜者
normal	正常 标准 
enormity	艰巨性  严重性  深重  滔天罪行
provincial	外省人


8.life at last returned to some semblance of ---  生活似乎终于恢复了正常
normality	常态 正常的形式
vanquished	战败者 被完全征服的人
victory	胜利  成功
province	省  外省  （学识或者活动的）领域  （兴趣和职责的）范围


9.i am -- proud of having made it on my own,with little financial help from my parents  我非常自豪自己能做到这一点，几乎没有父母的经济帮助
abnormally  反常地
conclusicely	最后地 决定性地
exclusively	独占地 排他地
immensely	非常 


10.if you have heart disease or --- blood pressure ,saunas can potentially be dangerous   如果你有心脏病或者血压不正常，蒸桑拿可能有潜在的危险。
tremendous	非常的 巨大的
normative	规范的 标准的
invincible		不可战胜的 无法改变的 坚定的
abnormal		反常的  不正常的




86lesson
1. she waited neryously for his anger to ---  她提心吊胆的等他的怒气平息下来
	besiege	围攻  包围  不断打扰
	besides	除了  此外  而且
	subside	减弱 平息 下陷
	subsidize	资助  补贴

2. they asked if i would --- at the committee meeting  他们问我是否愿意主持委员会会议
	baby-sit	带人临时照看小孩
	preside	主持  担任 主席
	reside	居住  存在
	saddle	马鞍  肩负

3.he was a white house official during the bush ---  他是布什总统任期内的一名白宫官员
	vice-president	副总统  副主席 副总裁
	presidency	总统的职位（任期内的）
	resident		居民 选项
	sit-up	仰卧起坐

4 please state your occupation and place of ---   请说明你的职业和所在地
	baby-sitter	保姆
	president		总统 国家主席
	residence		住宅 住所 居住
	residuals		残留物

5. they've slashed state --- to utilites and transportation  他们削弱了国家对公共事业和交通的补贴
	subsidiaries	子公司
	subsidies		津贴  补助金 
	residues		残留物
	residency		居住权 

6.they are hopeful of bringing the --- to a peaceful conclusion  他们希望以和平方式结束围困
	sitter 	带人临时看小孩
	siege	围困 围攻
	saddle	马鞍  肩负
	statue	雕像 雕塑

7. Malaria ia a ---- disease that causes high mortality  疟疾是一种造成高死亡率的潜在性疾病
	subsidized	被补贴了的
	precocious	早熟的 智慧超前的
	insidious		潜伏的 暗中为害的
	understated	朴素的  淡雅的

8.the main part of the army moved to Sevastopol to --- the town   军队主力转移到塞瓦斯托波尔，对该城进行了围攻
	prostitute	出卖 为钱而滥用 卖淫
	install	安装 安顿 正式任命
	restate	重申
	besiege	不断打扰  围攻 包围

9. the economics ministry has increasingly played a --- role to the finance ministry   经济部日益成为了财政部的附属机构
	resident	居住的  
	stately	缓慢而庄严的  正式的
	statutory	依照法令的 法定的
	subsidiary	辅助的  次要的

10. turn the hotplate off and allow the --- heat to keep the mixture simmering.  关掉加热板，让余热保持混合物沸腾
	residual	残留的
	statistical	统计的
	residential	住宅的
	presidential	总统的





























































